####################################################################################################
##.........[]....[][][][]...[]..##..[][][]......##........##..[][][][][]...[][][]...[][][][][]....##
##[]..............[][][][]##[].........[].[]##..................[][][][][].[]...............[][]..##
##....##...........[][].......[].........[][]...##....[].[]....[][].[]##..........................##
##..............................[]..##....##[]..[]..[]..[]##.......[][][].##....####.........[]...##
##..##..........[]..............[].........[].##..[][]..[].........[]...##........[]......[]......##
##[][].........[][].............[]........[]........[]..[].......[].............[][][]........[][]##
##.[].[]....##..####..##.......................[]............................[]...##..............##
##...[]...[].[]...[]..........##.....[]..[].....[]....##......[].................[][].............##
##..[][]..[].[]...##..........[]......##.[].....[]....[]....[]##.............[]..........[][][]...##
####[]##..##[]..[].........[]...[]##[]........................[].............[][].##..[]##....##[]##
##[][][][]............##..[][]##.[][].......................[][][]............####[][][][]##......##
##..[][]..............[][][][][][]##................[]....##........##......[][][]##[]####[]..##..##
##...[][]...............##[][]..............................[]..............[][]..[]##[][]..[]..[]##
##..##[].......[].......##[][]..........[]##[]..........##........[][]..[]..[].[][][].....[][]....##
##[][][]......##..........[][]..........[]......[]......[][][]##........##[][]..[][]........[]....##
##.[][][]......[][].......[][]....##[]...[]........[][]..[].[][][]....[]..[].[].[][][].......[]...##
##[].[]........[][].....##[]........##[]............##[].[]...[].....[][].##[][]............##....##
##[][].[][].....[][][]..[].[]....[]............................[].##........[]..............[]##[]##
##[][]..[]......[].[][].[][][].....[]........[]..[]....[].[].......[]...[]..[]..##....####..[][]####
##[][]..[]......[]..##.....[].................[].....[][]...............[]##.....[]...........[]..##
##..[]##[][]..##......[][]..[]....[]......##.[].##............................[]................[]##
##..[][][]........##....######....##......[][][][][]..[]..............##........................[]##
##.....[].[]........##[]..##........[].[]...[][]..[][]...[].....##................................##
##...[][].##.........[]...........##..[][]..##[].[].....[][]......................[]...........[].##
##....[]...[].........[]##........##....[]..##[][]........##......##.........[]..........[][].....##
##....[].[]...........[][]##......[][][]##[][][]..........[]......##........[].[].........[]##..[]##
##......[]............[]........[][]....[]....[]....[]......[]............##...[][]........[]...[]##
##..........[]...[]...[][]...[].[]....[][][][]..##[]........[]..[]##..........[]....[][]..[]......##
##...........[].[]..[][].....[][][].####[]....[][]##.......[].##[][][]........##....##[].[].......##
##[]..........[]...[].[]....[][]##.....[][].##[][]........[]##.....[][]..................[].....[]##
##...........[]......[].......[]............##..[]....[]...[][][]...##...........[]...............##
##......................[]..[]..##....[]..##[]......[][]##...[].....[][][][]....[]..............[]##
##............................##[]..................##...[]..............[]...[][]..[]##......[][]##
##.......[].[]....................[]##[]......................................[][][][][]......######
##......[]..##....##....##......................[]............[]....[]....[][][]..[]##[]......[][]##
##..........[]....................[]##........##........[].........[]......[].....##.[].......[]..##
##...........................[].....[].........[].....##...........[]......[][].....[]............##
##....##......[][]##....##..##.[].....##....[]..####[].......................[]...##..[]..........##
##[][][].......[].......[]....................[]##...............[]...[]....##[]..................##
##[]##[]..........[]..##..........##..........[].[][]......[]...[]...[]............[][]...........##
##[][].......[].....##[]..................[][][]..[].[]........[].##[]......[]..[]......[]##[]....##
####......[]....................##..........[][]##[][]............[]##.....[][][][].##[]##[]##..####
##......[][]..[][]..##.........[][][].....####..##[][]...........[].##..........[][]..............##
##[]....[]##....##...[].......[][]####.......[].[][]...@........[][][][]..[]....##[][]..####[]..####
####....[][]...[].......[][][]..........[][]....[]..............[]##..[][]....[]....[][]....[]....##
##.[]...##.........[]................[][][][][][][][]..[].[]...[].[]..[][][][][][]........##....####
####[]............##....[][]##..##....[]####.........[].####[]##[][][][][]##..[][]..[]..[][][]....##
####[][].........[].##[][][]..[]......[][]##..[]....##..##....[]..[]..[][]..##..[]....[]##..[]..####
####################################################################################################
