####################################################################################################
##..........[]....[]........[]..##..[][][]......##........##........[][]............[][][][]......##
##[]............[][][]....##....[]......[]..##................[]..[][][][]..[][][]................##
##....##....[]..[]....[]..............[]........##....[]..[]....[]..[]##......[][][]........[]....##
##..............[]....[]....[]..[]..##....##............[]##....[][]......##....####....[]..[]....##
##..##......[]........[]............[]......[]##..[][]..........[][]....##..[]....[]..............##
##[][][]..[]........[][][][][][][][]..[]......[]....[]..[]....[]..................[]........[]..[]##
##..[]......##..####..##..........[]..[]..[]......................[]........[][][]##[][]....[]....##
##..[][]..[]..[]..........[]..##[][]............[]..[]##..[]..[]................[][]..[]..........##
##......[]........##[][][]..[][][]..[]##..................[][]##..[]........[]..[]....[]..[][]....##
####[]##[]##..........[]....[]....##......[]..................[]..[]........[]....##[][]##....##[]##
##..[][]..[]..........##..[]..##..[]........[]......[]......[]....[]........[]####[]....[]##[]....##
##..[]....[]..[]............[][]..##....[]......[]..[]....##........##......[]..[]##..####....##..##
##............[]........##[]....[]..........[]..............[]....[]........[][]....##....[]....[]##
##..##..[]........[]....##[]..[]......[]..##......[]....##....................[][]......[]........##
##[][][]......##[]........[]....[]....[][][]....[]............##[]....[]##[]..........[]....[]....##
##............[]............[]....##..........[]..........[][][][]......[][]..[][][]..[]..........##
##..[]..[]....[]..[]....##..........##[][]....[][]..##[]....[][]....[]..[]##[]........[]....##....##
##..[]..[][][]....[]....[][]..................[]......[][][]......##....[][]..[]..[]..........##[]##
##..............[][]....[]......[][]............[][]..............[]..[]..[]....##....####..[]..####
##[]....[]..[]......##......[][]........[][]..........[]......[][][]......##[]....[]..[]..........##
##....##..[]..##[]....[][]..[][]....[]....##[][]##....[][][]..........[]........[][]..[]........[]##
##[]......[]....[]##....######....##[][][][]..[]..[]..[]..[]..........##[][][]........[]..[][][]..##
##........[]..[][]..##....##................[][]............[]..##....[]..[]..[]..................##
##..[]..[]##[]........[]........[]##....[]..##..@...........[]....[][]..............[][]....[][][]##
##[][][]................##....[][]##........##..[]..[]....##....[]##............................[]##
##....[]..[][]..[]..[]..[]##..[][]..[][]##[][]..[]........[][][]..##[]..[]......[][][]....[]##....##
##....................[]....[]..........[]....[]............[]............##[][]..[][]....[]......##
##........[]..[]......[]......[]..[]..[]..[][]..##[]..............##[]..[]......[]........[]......##
##............[]....[][]............####........[]##[]........##..[]..........##....##..[]......[]##
##....[]......[]......[]....[]..##..........##[][]....[]..[]##....[]........[]..[]..........[]....##
##[][]..........[]....[]..........[][]......##................[]..[]##[]....[][]....[]........[]..##
##..[][][]....[]......[]........##......[]##[]..[]..[]..##......[]..[]..........[]....[][]......[]##
##..[]....[]............[]....##....[]..............##..[][]....[]..[]................##..........##
##......[]..[]..[]....[][]....[][]..##..[]....[]......................[][]........[]..[][][]..######
##[]........##....##....##..........[][]....[]....[][]........[]............[]....[]##............##
##......[]..[]................[]....##..[]..[]##..........[]..[]..[]..[]....[]....##..[]..[]....[]##
##......[][]....[]..........[]........................##..........[]..[]..[]..........[][]....[]..##
##[][]##[]..[]..[]##....##..##....[]..##........####..[][][]............[]....[]..##......[]......##
##....[][]........[]..............[]..........[]##......[]..............[][]##[]......[]......[]..##
##..##..[][]..........##[][][]....##..............[]..[]..[]........[]............................##
##[]................##..[]..[][]........[][][]....[]..............##..[][]..[]..[]........##......##
####[]................[]..[]....##..........[][]##[]..[]..[][][][]..##......[][][]..##[]##[]##..####
##....[]........[]..##[][]........[][][]..####..##[]....[]....[]....##[]..[]....[][]..............##
##[]......##....##[]..[]..[][]....####..[]..[]....[]............[]..[]..[]......##[][]..####[]..####
####............................[][]......[]....[]................##..........[]....[][]....[]....##
##..[]..##[]..[][]......[][]..[]..[]..[]....[][][]........[]..[]..[]......[][]..[]........##....####
####[]..........[]##........##[]##....[]####............####..##[][][][]..##..[][]..[]..[][][]....##
####..[]............##................[][]##..[]....##..##....[]..[]..[][]..##..[]....[]##..[]..####
####################################################################################################
